NO ./textures/north.xpm
WE ./textures/west.xpm
EA ./textures/east.xpm
SO ./textures/south.xpm

F 255,255,255
C 0,0,0

11111111111111111111111111111111111111111111111111111111111111111111111111111111111111111111111111111
10000000000000000000000000000000000000000000000000000000000000000000000000000000000000000000000000001
10000000000000000000000000000000000000010000000000000000000000000000000000000000000000000000000000001
10000000000000000000000000000000000000000000000000000000000000000000000000000000000000000000000000001
10000000000000000000000000000000000000111000000000000000000000000000000000000000000000000000000000001
10000000000000000000000000000000000000000000000100000000000000000000000000000000000000000000000000001
10001000000000000000000000000000001000000000000100000000000000000000000000000000000000000000000000001
1000000000000000000000000000000000000000E000000100000000000000000000000000000000000000000000000000001
10000000000000000000000000010000000000000000000100000000000000000000000000000000000000000000000000001
10000000000000000000000000000000000000000000000100000000000000000000000000000000000000000000000000001
10000000000000000000000000000000000000000000000000000000000000000000000000000000000000000000000000001
10000000000000000000000000000000000000000000000000000000000000000000000000000000000000000000000000001
10000000000000000000000000000000000000000000000000000000000000000000000000000000000000000000000000001
10000000000000000000000000000000000000000000000000000000000000000000000000000000000000000000000000001
10000000000000000000000000000000000000000000000000000000000000000000000000000000000000000000000000001
10000000000000000000000000000000000000000000000000000000000000000000000000000000000000000000000000001
10000000000000000000000000000000000000000000000000000000000000000000000000000000000000000000000000001
10000000000000000000000000000000000000000000000000000000000000000000000000000000000000000000000000001
11111111111111111111111111111111111111111111111111111111111111111111111111111111111111111111111111111