11111111111
10000000001
10000N01001
10000100001
11111111111