1111111111
1000000001
1000010001
10010000011
1000N00001
1111111111
     1
