NO ./textures/north.xpm
SO ./textures/south.xpm
WE          ./textures/west.xpm
EA ./textures/east.xpm

F 0,0,40
C 255,254,250





11111111111111111111111111111111111111111111111111111111111111111111111111111111111111111111111111111
10000000000000000000000000000000000000000000000000000000000000000000000000000000000000000000000000001
10000000000000000000000000000000000000000000000000000000000000000000000000000000000000000000000000001
10000000000000000000000000011111111111111111111111111111100000000000000000000000000000000000000000001
1000000000000000000000000001                            100000000000000000000000000000000000000000001
1000000000000000000000000001                            10000000000000000000000000000000000000000001
1000100000000000000000000001                            100000000000000000000000000000000000000000001
1000000000000000000000000001                            100000000000000000000000000000000000000000001
1000000000000000000000000001                            100000000000000000000000000000000000000000001
1000000000000000000000000001                            100000000000000000000000000000000000000000001
10000E0000000000000000000001                            100000000000000000000000000000000000000000001
1000000000000000000000000001                            100000000000000000000000000000000000000000001
1000000000000000000000000001                            100000000000000000000000000000000000000000001
10000000000000000000000000011111111111111111111111111111100000000000000000000000000000000000000000001
10000000000000000000000000000000000000000000000000000000000000000000000000000000000000000000000000001
10000000000000000000000000000000000000000000000000000000000000000000000000000000000000000000000000001
10000000000000000000000000000000000000000000000000000000000000000000000000000000000000000000000000001
10000000000000000000000000000000000000000000000000000000000000000000000000000000000000000000000000001
11111111111111111111111111111111111111111111111111111111111111111111111111111111111111111111111111111
111
111
11
