NO ./textures/north.xpm
SO ./textures/south.xpm
WE          ./textures/west.xpm
EA ./textures/east.xpm

F 25,2,250


C 040,070,070





11111111111111111111111111111111111111111111111111111111111111111111111111111111111111111111111111111
10000000000000000000000000000000000000000000000000000000000000000000000000000000000000000000000000001
10000000000000000000000000000000000000000000000000000000000000000000000000000000000000000000000000001
10000000000000000000000000000000000000000000000000000000000000000000000000000000000000000000000000001
10000000000000000000000000000000000000111000000000000000000000000000000000000000000000000000000000001
1000000000000000000000000000000000000000000000100000000000000000000000000000000000000000000000000001
10001000000000000000000000000000001000000000000100000000000000000000000000000000000000000000000000001
10000000000000000000000000000000000000000E00000100000000000000000000000000000000000000000000000000001
10000000000000000000000000010000000000000000000100000000000000000000000000000000000000000000000000001
10000000000000000000000000000000000000000000000100000000000000000000000000000000000000000000000000001
10000000000000000000000000000000000000000000000000000000000000000000000000000000000000000000000000001
10000000000000000000000000000000000000000000000000000000000000000000000000000000000000000000000000001
10000000000000000000000000000000000000000000000000000000000000000000000000000000000000000000000000001
10000000000000000000000000000000000000000000000000000000000000000000000000000000000000000000000000001
10000000000000000000000000000000000000000000000000000000000000000000000000000000000000000000000000001
10000000001111111111111111111111111111111111111111111111111111111111111111111111111110000000000000001
10000000000000001111111111111111111111111111111111111111111111111111111111111111111110000000000000001
10000000000000000000000000000000000000000000000000000000000000000000000000000000000000000000000000001
11111111111111110111111111111111111111111111111111111111111111111111111111111111111111111111111111111
111
111
11
